XXCCCCCC
XXXXXXXF
CXXXXXXW
BXXXCPCC
CXXXXXXX
CXTTXXXX
CCCCCXXX
XXXXXXXX
