XXXXXXXXXXXXXXX
XXXMOXXPXDXXXXX
XX        XXXXX
XX        WXXXX
XX        XXXXX
XX        BXXXX
XX        XXXXX
XXXXXXX   XXXXX
XXXXXXS   XXXXX
XXXXXXXXXXXXXXX
