XXXXXXXXXXXXXXX
X  XXBOWXXXXXXX
X       XXXXXXX
XS      DXXXXXX
XS      PXXXXXX
X       MXXXXXX
X XXXXXXXXXXXXX
X        XXXXXX
X        XXXXXX
XXXXXXXXXXXXXXX
