XXXXXXXXXXXXXXX
XXXBXXPXDXXXXXX
XX        SXXXX
XW        SXXXX
XX        XXXXX
XM        XXXXX
XO        XXXXX
XX        XXXXX
XXXXXXXXXXXXXXX
XXXXXXXXXXXXXXX
