XXXXXXXXXXXXXXX
XXXBXXPXDXXXXXX
XX        SXXXX
XW 2      SXXXX
XX        XXXXX
X       1 XXXXX
X         XXXXX
XX        XXXXX
XXXXXXXXXXXXXXX
XXXXXXXXXXXXXXX
