XXXXXXXXXXXXXXX
XXXXXBOWXXXXXXX
XX      XXXXXXX
XS      DXXXXXX
XS      PXXXXXX
XX      MXXXXXX
XXXXXXXXXXXXXXX
XXXXXXXXXXXXXXX
XXXXXXXXXXXXXXX
XXXXXXXXXXXXXXX
