XXXXXXXX
CCCXCCCC
XXXXXXXX
CCCCCCCC
XXCCCCXX
XXXXXXXX
XXCCCCXX
CCCCCCCC