XXXXXXXX
CXXXTTXX
CXXXXXXX
BXXXCBCC
CXXXXXXC
HXXXXXXW
CXXXXXXC
CXXXCFCC