XXXXXXXC
XXXXXXXC
TTXBXXXP
XXXWXXXH
XXXCXXXC
XCCCFCBC
XXXXXXXX
XXXXXXXX