CBCWCCCC
CXXXXXXX
HXXXXXXF
CXXXXXXC
XXXXXXXB
XXXXXXXC
XXXTTXXX
XXXXXXXX