CBHCCXXX
CXXXCXXX
HXXXWXTX
CXXXCXTX
CXXXBXXX
FXXXCXXX
CXXXXXXX
CXXXXXXX