FXXXXXXB
CXXXXXXC
BXXCTXXX
HXXCTXXX
HXXCCXXC
CXXWCXXC
CXXXXXXC
CXXCCCCC