CHCHBXXX
WXXXXXXX
BXXXXXXX
FXXXTXXX
CXXXTXXX
XXXXXXXX
XXXXXXXX
XXXXXXXX