CCCCCBFC
XXXXXXXC
XXXXXXXP
XXXXXXXP
XXXXXXXC
XXXCBWCC
TTXXXXXX
XXXXXXXX