CCCCHCBF
CXXXXXXX
CXXXXXXX
WXXXXXXX
CXXXXXXX
CBCTTXXX
XXXXXXXX
XXXXXXXX