CCBFCCXX
CXXXXXXX
HXXXXXXX
CXXTTXXX
WXXXXXXC
CXXXXXXH
XXXXXXXC
XXXXCBCC