XXXXXXXX
CCHPCCCX
BXXXXXFX
WXXXCCCX
BXXXXXCX
CXXTTXCX
CXXXXXXX
XXXXXXXX