CCCCCHHC
XXXCXXXB
XTXWXXXC
XTXCXXXC
XXXBXXXC
XXXXXXXF
XXXXXXXC
XXXXXXCC