XTCCWCCC
XTXXXXXC
XXXXXXXP
XXXXXXXB
XXXXXXXB
XXXXXXXF
XXXXXXXX
XXXXXXXX