CCCCWBCC
CXXXXXXF
CXXXXXXB
CXXTXXXP
XXXTXXXC
XXXXXXXC
XXXXXXXF
XXXXXXXX