XXXXXXXX
XXXXXXXC
XXTTCXXC
XXXXWXXP
XXXXXXXC
XXXXXXXC
XXXXXXXF
CBBHXXXX