XXXXXXXX
XXXXXXXX
XXXXXXXX
XXCWCBXX
XXXXXXXT
CXXXXXXT
BXXXXXXX
CFCHHCXX