XXXXXXXC
XXXXXXXC
XXTXXXXW
XXTXXXXC
XXXXXXXH
XXXXXXXH
XXXXXXXB
XCFCBCCC