XCCCCWCC
XXXBXXXC
XXXCXXXH
XTXXXXXC
XTXXXXXC
XXXCXXXH
XXXCXXXB
XCCCCFCC