XXXXXXXF
XXTTXXXB
XXXXXXXC
XXXXXXXH
XXCCWBCC
XXXXXXXC
XXXXXXXH
XXXXXXXC