CCHCCFCC
BXXXXXXX
CXXXXXXX
CXXCWCXX
CXXBCCXX
XXXXXXXX
XXXTTXXX
XXXXXXXX