XXXXXXXX
CXXXXXXC
BXXXXXXF
PXXXTXXX
PXXXTXXB
CXXXXXXW
CXXXXXXC
XXXXXXXX