XXXXXXXX
XXXCXXXF
XXXWXXXC
XXXCXXXH
XTXBXXXP
XTXBXXXC
XXXCXXXC
XXXXXXXX