XXXXXXXX
XCCFWCCC
XBXXXXXP
XCXXXXXC
XXXTTXXC
XXXXXXXB
XXXXCCCC
XXXXXXXX