FXXXXXTX
CXXXXXTX
BXXXXXXX
CXXXCXXX
HXXXCXXX
HXXXWXXX
CXXXCXXX
CXXXBXXX