CCCCCXXX
BXXXXXXX
CXXCBXXF
HXXWCXXC
HXXCCXXC
CXXXXXXC
XXTTXXXX
XXXXXXXX