CCCWCCCC
CXXXXXXC
CXXCCXXP
XXXCCXXC
XXXBBXXC
XXXTTXXF
XXXXXXXX
XXXXXXXX