XXXXXXXX
XTTXXXXX
XXXXXXXX
XXXXXBCC
XXXXXXXH
XXXXXXXC
XXXXXXXB
XXXCFCWC