XXXCBWCC
CXXXXXXC
CXXXXXXH
FXXXXXXH
CXXXXXXC
BXXXTTXC
CXXXXXXC
CCCCCCCC