CXXXXXXX
BXXXXXXX
CXXXXXXX
WXXXCXXT
CXXXCXXT
CXXXHXXX
CXXXHXXX
FXXXBXXX