CCCCWCCC
XXXXXXXX
XXXCCXXF
TXXCHXXC
TXXCPXXC
XXXCBXXB
XXXXXXXX
CXXXXXXX