CFCCCCCC
XXXXXXXX
XXXXXXXX
XXCBWCXX
XXXTTXXX
XXXXXXXX
XXXXXXXX
CCCHPBCC