XXXXXXXX
CCFCBCCX
CXXXXXCX
BXXXXXPX
WXTTXXCX
CXXXXXCX
CXXXXXXX
XXXXXXXX