CCCHHCCC
CXXXXXXF
BXXXXXXB
CXXCCWCC
CXXXXXXC
XXXXTTXC
XXXXXXXC
XXXXCCCC