CXXXXXXX
CXXXXXXX
CXXXXXXX
CXXCTTCC
CXXXXXXC
HXXXXXXW
CXXXXXXC
CFCCHCCC