XXXXXXXX
CCFCBCCX
CXXXXXCX
BXXXXXPX
WXTTXXCX
CXXXXXKX
CXXXXXXX
XXXXXXXX