XXXXTTXX
XXXXXXXX
XCCCCCWC
XXXXXXXX
XXXXXXXX
XXXXXXXX
XXXXXXXX
XBCHHCBF