XCCCBBCC
XXXXXXXC
XXXXCXXC
XXTTWXXH
XXXXCXXP
XXXXXXXC
XCCCCCFC
XXXXXXXX