XXXXXXXX
XXXXXXXX
XXXXXXXX
XXXTTXXC
XXXXXXXC
XXXCWBXH
XXXXXXXC
XXXCCFBC