XXXXXXXX
XXXXXXXX
XXXXXXXX
XXTXXXXX
XXTXXXXX
XXXXXXXX
XXXXXXXX
BCWBCHCF