XXXXXXXX
XXXXXXXX
FXXXXXCC
CXXXXXXC
HXXTTXXC
HXXXXXXB
CXXXXXXX
XXCCWCBX