XXXXXXXX
XXXTTXXX
XXXXXXXX
XXCBCCXX
XXXXXXXX
XXXXXXXX
XXXXXXXX
CWCHHCBF