XXCCBCWC
XXXXXXXC
TXXXXXXP
TXXXXXXP
XXXXXXXC
XXCBFCCC
XXXXXXXX
XXXXXXXX