FXXXXXXX
CXXXXXXB
HXXXXXXC
HXXXXXXW
CCCBCXXC
XXXXXXXC
XXTTXXXX
XXXXXXXX