CCCWCCCC
CXXXXXXC
FXXXXXXB
CXXHPXXB
CXXXXXXC
XXXXXXXX
XXXTTXXX
XXXXXXXX