XXXXXXXX
XXXCCPCC
XTXCXXXC
XTXWXXXF
XXXCXXXB
XXXCXXXC
XXXXXXXC
XXXCCBCC