XXXXXXXX
XXXXXXXX
XXXXXXXX
CXXXXCCC
HXXXXXXC
HXXXTTXX
CXXXXXXX
CBWCFCBX