XXXXXXXX
XXXXCWBC
XXXXXXXC
XXXXXXXH
CCTTXXXC
CXXXXXXF
CXXXXXXC
CCCCCBCC