FXXXXXXX
CXXXXXTX
HXXXXXTX
CXXXXXXX
CXXXCCXX
BXXXXHXX
CXXXXCXX
CCCWBCXX