CXXXXXXF
HXXXXXXB
CXXXXXXC
CXCWBCCC
XXXXXXXX
XXXXXTTX
XXXXXXXX
XXXXXXXX