XXXXXXXX
XXXXXXXX
XXXXXXXX
XXTTXXXX
XXXXXXXX
BXXXXXXC
HXXXXXXW
CCPCCFBC