CBWCCXXX
CXXXCXXX
PXXXCXXT
PXXXCXXT
CXXXBXXX
CXXXXXXX
CXXXXXXX
CXXCCFCC