XXXXXXXC
XTTXXXXB
XXXXXXXC
XXCXXXXC
XXFXXXXC
XXBXXXXW
XXCXXXXC
XXCCHHCC