FXXXXXXX
BXCWCXXX
CXXXXXXX
HXXXXXXX
CXXXXXXX
BXXXTXXX
CXXXTXXX
XXXXXXXX