CFCBWCCC
XXXXXXXB
XXXXXXXH
TTXXXXXH
XXXXXXXC
XXXXXXXC
XXXXXXXX
XXXXXXXX