CCFCXXXX
XXXXXXXC
XXXXXXXC
CXXBCXXC
PXXBCXXW
HXXXXXXC
CXXXXXXC
CCTTXXXC