CCBCCHHC
FXXXXXXC
CXXXXXXW
CXXXXXXC
CXXXXXXC
XXXTTXXB
XXXXXXXC
CCCCCCCC