CCKCPCDCFC
CXXXXXXXXC
WXXXXXXXXC
CXXXXXXXXG
CCCCCXXXXC
CTTCCXXXXC
CXXXXXXXXC
CCCCCCCCCC
