XXKCBCWC
XXXXXXXC
TXXXXXXP
TXXXXXXP
XXXXXXXC
XDCBFCGC
XXXXXXXX
XXXXXXXX