CCFGCCPCDC
CXXXXXXXXC
CXXXXXXXXW
CXXXXXXXXC
CXXXXXXXXK
CXXXXXXXXC
CCCCCCXXXC
CCCCTTXXXC