CCKCPCDCFC
CXXXXXXXXC
WXXXXXXXXC
CXXXXXXXXC
CCCCCXXXXG
CTTCCXXXXC
CXXXXXXXXC
CCCCCCCCCC
