CCDCWCPCCCCCC
CXXXXXXXXXXXF
CXXXXXXXXXXXG
CXXXXXXXXXXXC
CXXXCKCCCXXXC
CXXXCCTTCXXXC
CXXXXXXXXXXXC
CXXXXXXXXXXXC
CCCCCCCCCCCCC