CCCCKGWC
CXXXXXXC
TXXXXXXD
TXXXXXXP
CXXXXXXF
CCCCCCCC