CCKCPCDCFC
CXXXXXXXXG
WXXXXXXXXC
CXXXXXXXXC
CCCCCXXXXC
CTTCCXXXXC
CXXXXXXXXC
CCCCCCCCCC
