CCGCFCCCPCCDC
CXXXXXXXXXXXC
CXXXXXXXXXXXC
CXXXXXXXXXXXC
CXXXCKWCCXXXC
CXXXCCTTCXXXC
CXXXXXXXXXXXC
CXXXXXXXXXXXC
CXXXXXXXXXXXC
CCCCCCCCCCCCC