CCKCCPCDCC
CXXXXXXXXT
WXXXXXXXXT
CXXXXXXXXC
MXXXXXXXXC
OXXXXXXXXC
CXXXXXXXXC
CCCCCCCCCC