XXCCKGWC
XXXXXXXC
TXXXXXXD
TXXXXXXP
XXXXXXXF
XCCBCCCC
XXXXXXXX
XXXXXXXX