CCKCCPCDCC
CXXXXXXXXT
WXXXXXXXXT
CXXXXXXXXC
FXXXXXXXXC
GXXXXXXXXC
CXXXXXXXXC
CCCCCCCCCC